1111111111111111111
1P000000000C0000001
1011111111101111101
10000000000000000C1
1110111111101111101
1000100000000000001
1011101111110111101
10000000000000000E1
1111111111111111111